NO ./textures/path_north.xpm
SO ./textures/path_south.xpm
WE ./textures/path_west.xpm
EA ./textures/path_east.xpm
F 220,100,0
C 225,30,0

1111111111
10001111
1000000N11111
11111111