	NO    ./textures/test_north.ppm
SO  ./textures/test_south.ppm
WE  ./textures/test_west.ppm
EA  ./textures/test_east.ppm

F 220,100,0 
C 225,30,0                                                                                         
                                                                                                   
                                                                                                   
                                                                                                   
     11111111111111111111111111111111111111111111111111111111111111111111111111111111111111111111  
     10001000000000000000000000000000000000000000000000000000000000000000000000000000000000000001  
     10001000000000000000000000000000000000000000000000000000000000000000000000000000000000000001  
     10001000000000000000000000000000000000000000000000000000000000000000000000000000000000000001  
     10001000000000000000000000000000000000000000000000000000000000000000000000000000000000000001  
     10001000000000000000000000000000000000000000000000000000000000000000000000000000000000000001  
     10001000111111111111111111111111111111111111111111111111111111111111111111111111111111100001  
     10001000000000000000000000000000000000000000000000000010000000000000000000000000000000100001  
     10001000000000000000000000000000000000000000000000000010000000000000000000000000000000100001  
     10001000000000000000000000000000000000010000000000000010000000000000000000000000000000100001  
     10001000000000000000000000000000000000010000000000000010000000000000000000000000000000100001  
     10001000000000000000000000000000000000010000000000000010000000000011111111111100000000100001  
     10001000000000000000000000000000000000010000000000000010000000000010000000000100000000100001  
     10001000000000000000000000000000000000010000000000000010000000000010000000000100000000100001  
     10001000000000000000000000000000000000010000000000000010000000000010000000000100000000100001  
     10001000000000000000000000000000000000010000000000000010000000000010000000000100000000100001  
     10001000000000000000000000000000000000010000000000000010000000000010000000000100000000100001  
     10001000000000000000000000000000000000010000000000000010000000000010000000000100000000100001  
     10001000000000000000000000000000000000010000000000000010000000000010000000000100000000100001  
     10001000000000000000000000000000000000010000000000000010000000000010000000000100000000100001  
     10001000000000000000000000000000000000010000000000000010000000000010000000000100000000100001  
     10001000000000000000000000000000000000010000000000000010000000000010000000000100000000100001  
     10001000000000000000000000000000000000010000000000000010000000000010000000000100000000100001  
     10001000000000000000000000000000000000010000000000000010000000000010000000000100000000100001  
     10001000000000000000000000000000000000010000000000000010000000000010000000000100000000100001  
     10001000000000000000000000000000000000010000000000000010000000000010000000000100000000100001  
     10001000000000000000000000000000000000010000000000000010000000000010000000000100000000100001  
     10001000000000000000000000000000000000010000000000000010000000000010000000000100000000100001  
     10001000000000000000000000000000000000010000000000000010000000000010000000000100000000100001  
     10001000000000000000000000000000000000010000000000000010000000000010000000000100000000100001  
     10001000000000000000000000000000000000010000000000000010000000000010000000000100000000100001  
     10001000000000000000000000000000000000010000000000000010000000000010000000000100000000100001  
     10001000000000000000000000000000000000010000000000000010000000000010000000000100000000100001  
     10001000000000000000000000000000000000010000000000000010000000000010000000000100000000100001  
     10001000000000000000000000000000000000010000000000000010000000000010000000000100000000100001  
     10001000000000000000000000000000000000010000000000000010000000000010000000000100000000100001  
     10001000000000000000000000000000000000010000000000000000000000000010000000000100000000100001  
     10001000000000000000000000000000000000010000000000000000000000000010000000000100000000100001  
     10001000000000000000000000000000000000010000000000000000000000000010000000000100000000100001  
     10001111111111111111111111111111111000010000000000000000000000000010000000000100000000100001  
     10000000000000000000000000000000000111111111111111111111111111111110000000000100000000100001  
     10000000000000000000000000000000000000000000000000000000000000000000000000000100000000100001  
     10000000000000000000000000000000000000000000000000000000000000000000000000000100000000100001  
     10000000000000000000000000000000000000000000000000000000000000000000000000000100000000100001  
     10000000000000000000000000000000000000000000000000000000000000000000000000000000000000100001  
     11100000000000000000000000000000000000000000000000000000000000000000000000000100000000100111 
       1111111111111111111111111111111111111100111111111111111111111111111111111111111111111111       
     11100000000000000000000000000000000000000000000000000000000000000000000000000100000000100111  
     10000000000000000000000000000000000000000000000000000000000000000000000000000100000000100001  
     10000000000011111111111111111111111111110111111111111111111111111111111111111100000000100001  
     10000000000010000000000000000000000000000000000000000000000000000000000000000100000000100001  
     10000000000010000000000000000000000000000000000000000000000000000000000000000100000000100001  
     10000000000010000000000000000000000000000000000000000000000000000000000000000100000000100001  
     10000000000010000000000000001111111111111111111111111111111111111111111000000100000000100001  
     10000000000010000000000000000000000000000000000000000000000000000000001000000100000000100001  
     10000000000010000000000000000000000000000000000000000000000000000000001000000100000000100001  
     10000000000010000000000000000000000000000000000000000000000000000000001000000100000000100001  
     10000000000010000000000000000000000000000000000000000000000000000000001000000100000000100001  
     10000000000010000000000000000000000000000000000000000000000000000000001000000100000000100001  
     10000000000010000000000000000000000000000000000000000000000000000000000000000100000000100001  
     10000000000010000000000000000000000000000000000000000000000000000000000100000100000000100001  
     10000000000010000000000000000000000000000000000000000000000000000000000100000100000000100001  
     10000000000010000000000000000000000000000000000000000000000000000000000100000100000000100001  
     10000000000010000000000000000000000000000000000000000000000000000000000100000100000000100001  
     10000000000010000000000000000000000000000011111111111111111111111111111100000100000000100001  
     10000000000011111111111111111111111111111100000000000000000000000000000000000100000000100001  
     10000000000000000000000000000000000000000000000000000000000000000000000000000100000000100001  
     11000000000000000000000000000000000000000000000000000000000000000000000000000100000000100001  
     1000000000000000000000000000000000000000000000000W000000000000000000000000000100000000100011
     11000000000000000000000000000000000000000000000000000000000000000000000000000100000000100001  
     10000000000000000000000000000000000000000000000000000000000000000000000000000100000000100001  
     10000000000000000000000000000000000000000000000000000000000000000000000000000100000000100001  
     10000000001111111111111111111111111111111111111111111111111111111111111111111100000000100001  
     10000000001000000000000000000000000000000000000000000000000000000000000000000000000000100001  
     10000000001000000000000000000000000000000000000000000000000000000000000000000000000000100001  
     10000000001000000000000000000000000000000000000000000000000000000000000000000000000000100001  
     10000000001000000000000000000000000000000000000000000000000000000000000000000000000000100001  
     10000000001000000000000000000000000000000000000000000000000000000000000000000000000000100001  
     10000000001000000000000000000000000000000000000000000000000000000000000000000000000000100001  
     10000000001000000000000000000000000000000000000000000000000000000000000000000000000000100001  
     10000000001000000000000000000000000000000000000000000000000000000000000000000000000000100001  
     10000000001000000000000000000000000000000000000000000000000000000000000000000000000000100001  
     10000000001000000000000000000000000000000000000000000000000000000000000000000000000000100001  
     10000000001000000000000000000000000000000000000000000000000000000000000000000000000000100001  
     10000000001000000000000000000000000000000000000000000000000000000000000000000000000000100001  
     10000000001000000000000000000000000000000000000000000000000000000000000000000000000000100001  
     10000000001000000000000000000000000000000000000000000000000000000000000000000000000000100001  
     10000000001000000000000000000000000000000000000000000000000000000000000000000000000000100001  
     10000000001000000000000000000000000000000000000000000000000000000000000000000000000000100001  
     10000000001111111111111111111111111111111111111100000000000000000000000000000000000000000001  
     10000000000000000000000000000000000000000000000011111111111111111111111111111111111111100001  
     10000000000000000000000000000000000000000000000000000000000000000000000000000000000000000001  
     10000000000000000000000000000000000000000000000000000000000000000000000000000000000000000001  
     11111111111111111111111111111111111111111111111111111111111111111111111111111111111111111111  