NO ./textures/path_north.xpm
SO ./textures/path_south.xpm
WE ./textures/path_west.xpm
EA ./textures/path_east.xpm
F 220,100,0
C 225,30,0

11111
10001
10001
10001
10001
10001
11001
10001
10001
10001
10001
11S11
       
