       
 11111 
 10001 
 10S01 
 10001 
 10001 
 10001 
 11E01 
 10001 
 10001 
 10001 
 10001 
 10001 
 11111 
       