      
 1111 
 10 1 
 1111 
       